111111111
110P00011
1000C0011
111010011
100000E01
111111111
