11111111111
1000C00CC01
100000P00C1
100CCC0E001
1000C00CC01
11111111111
